XXXXXXXXXXXXXXXXXXXXXXXXXXXXXXXXXXXXXXXXXXXXXXXXXXXXXXXXXXXXXXXXXXXXXXXXXXXXXXXXXXXXXXXXXXXXXXXXXXXXXXXXXXXXXXXXX
X                                                                                                               X
X                                                                                                               X
X                                                                                                               X
X                                                                                                               X
X                                                                                                               X
X                                               X                                                               X
X                                                                                                               X
X           X                               X             X                      X                              X
X                                                                                                               X
X                                                                                                               X
X P                  E1                              E1                   E1             XXX     E1             X
XXXXXXXXXXXXXXXXXXXXXXXXXXXXXXXXXXXXXXXXXXXXXXXXXXXXXXXXXXXXXXXXXXXXXXXXXXXXXXXXXXXXXXXXXXXXXXXXXXXXXXXXXX      X
X                                                                                                               X
X                                                                                                               X
X                                                                                                               X
X                                                                                                               X
X                                                                                                               X
X                                                                                                               X
X                                  X                                                                            X
X                                                                                                               X
X                   XX       XX         X            X                                                          X
X                 XXXXXX                                                                                        X
X      XX       XXXXXXXX                     XXX          XXXX                                   XXX            X
X      XXX    XXXXXXXXXX                                  XXXX   XE2            XE2              XXX            X
X      XXXXXXXXXXXXXXXXXXXXXXXXXXXXXXXXXXXXXXXXXXXXXXXXXXXXXXXXXXXXXXXXXXXXXXXXXXXXXXXXXXXXXXXXXXXXXXXXXXXXXXXXXX
X                                                                                                               X
X                                                                                                               X
X                                                                                                               X
X                                                                                                               X
X                                                                                                               D
X                                                                                                               D
X                                                                                                               D
XXXX                                                                                                            D
X                 XXXX     XX     V       XX     V        XX     V       XXXXX     XXXXXX     XX                D
X               XXXXXX                                                    XX         XX       XXXX              D
X             XXXXXXXX                                                    XX         XX       XXXXXX            D
X           XXXXXXXXXX                                                    XX         XX       XXXXXXXX          D
XXXXXXXXXXXXXXXXXXXXXXXXXXXXXXXXXXXXXXXXXXXXXXXXXXXXXXXXXXXXXXXXXXXXXXXXXXXXXXXXXXXXXXXXXXXXXXXXXXXXXXXXXXXXXXXXX