                                                               X 
                                                               X
                                                               X
                                                    XXX        X
                                                               X
                                                               X
         X                                                XXXXXX
                                                               X     XXXXXXXXXXXXXXXXXXXXXX
                                                    XXX        X     X                    X
                                                               XXXXXXX                    X
                                          XXXX                                            X
                                                                                          X
                 XXXXXX                                                                   X
                             X                     XXXXX                                  X
P                                                              XXXXXXX                    X
X                                                              X     X                    X
X                                             X             XXXX     X                    X
X                                                              X     XXXXXXXX       XXXXXXX
X                    X          XXXXX                          X             X            
X     X                                                                      X            
X                                           XXX                               X           
X                                                                              X          
X                                    X                                          X         
XXXXXXXXXXXXXXXXXXXXXXXXXXXXXXXXXXXXXXXXXXXXXXXXXX         XXXXXXXXXXXXXXXXXXXXXXXXXXXXXXXX
                                                 X         X
                                                 X         X
                                                 X       XXX
                                                 X         X
                                                 X         X
                                                 XXX       X
                                                 X         X
                                                 X         X
                                                 X       XXXXXXXXXXXXXXXXXXXXXXXXXXXXXXXXXXXX
                                                 X                                          X
                                                 X                                          X
                                                 XXX                                        X
                                                 X                                          X
                                                 XXXXXXXXXXXXXXXXXXXXXXXXXXXXXXXXXXXXXXXXXXXX