








X                                                                                                                                                                                       K
X                                                                                                                                                                                       
X                           XXXXXXXXXXXXXXXXXXXXXXXXXXXXXXXXXX V                                                                                                                 XX X X   
X                           X                                X                            CC                             L                                                              X2  
X                   XXXXXXXXX                                X                         XXXXXXXXXXXXXXXXXXXXXXXXXX H    XXXXXXX                                  C             XX        X2X H                     XX
X         XXXX    XXXXX     X                                X                     CC               X                         X                                 C                       X2                        XX
X P                                             E1  L      K  B                    XXXXXXX           X            XX                                            C                 XX    X2      L                 XX
XXXXXXXXXXXXXXXXXXXXXXXXXXXXXXXXXXXXXXXXXXXXXXXXXXXXXXXXXXXXXXXXXXXXXXXXX                 XXXXXXXXXXX                         XXX                              X2X2                     X2      C                 XX
X                                                                        X            CC XXXXX                     XX                                        X2X2X2X2        XX         X2                        XX
X                                                                         X     CC CC   XXXXXX                          E2        XX                       X2X2X2X2X2X2                 X2                        XX
X                                                                          XXXXXXXXXXXXXXXXXXXXXXXXXXXXXXXXXXXXXXXXXXXXXXXXXXXXXXXXXXXXXXXXXXXXXXXXXXXXXXXXXXXXXXXXXXXXXXXXXXXXXXXXXXXXXXXXXXXXXXXXXXXXXXXXXXXX   XX
X                                                                                                                                                                                                                 XX    
X                                                                                                                                                                                                                 XX                                                                                                    
X                                                                                                                                                                                                                 XX       
X                                                                                                                                                                                                                 XX 
X                       XBBBLBBBBX                                                                                                                             C C C C                                            XX       
X                       XBBBBBBBBX                                                                                                                         XXXXXXXXXXXXXXXXXX                                     XX    
X                       XXX      X                                                                                                                         XXXXXXXXXXXXXXXXXXXX                                   XX     
X                                                                                      BBB                                                                                                                        XX
X                                                                                      BBB                              E1                                                                                        XX
X   XXXXXXXXXXXXXXXXXX              XXXXXXXXXXXXXXXXXXXXXXXXXXXXXXXXXXXXXXXXXXXXXXXXXXXXXXXXXXXXXXXXXXXXXXXXXXXXXXXXXXXXXXXXXXXXXXXXXXXXXXXXXXXXXXXXXXXXXXXXXXXXXXXXXXXXXXXXXXXXXXXXXXXXXXXXXXXXXXXXXXXXXXXXXXXXXXXX           
X                      XXXXXXXXXXXXX                                                                                                                                                                              XX
X                                                                                                                                                                                                                 XX      
X                                                                                                                                                                                                                 XX
X                                                                                                                                                                                                                 XX
X                                                                                                                                                                                                                 XX
X                                                                                                                                                                                                                 XX
X                                                                                                                                                                                                                 XX
X                                                                                                                                                                                                                 XX
X                                                                                                                                                                                                                 XX
X                                                                                                                                                                                                                 XX
X                                                                                                                                                                                                                 XX
X                          XXXXXXXX V XXXXXXXXXX                                                                                                                                                                  XX
X                         XX                   X                                                               XXXXBBBXXXXXX                                                                                      XX
X                        XXX                   X                                                               BBBBBBBBBBBBX                                                                                      XX
X                       XXXX                   X                                                              XXXXXBLBXXXXXX                                                                                      XX
X                     XXXXXX                   X                                                            XXXXXXXXXXXXXXXXXXX                                                                                   XX
X                    XXXXXXX                   B                                                                                                                                                                  XX
X                  XXXXXXXXX    E1  L          B                                                                                                                                                                  XX
XXXXXXXXXXXXXXXXXXXXXXXXXXXXXXXXXXXXXXXXXXXXXXXXXXXXXXXXXXXXXXXXXXXXXXXXXXXXXXXXXXXXXXXXXXXXXXXXXXXXXXXXXX                      CCCCCXXXXXXXXXXXXXXXXXXXXXXXXXXXXXXXXXXXXXXXXXXXXXXXXXXXXXXXXXXXX                 XX 
X                                                                                                          X2I                 CCCC X2                                                                            XX
X                                                                                                           X2                 CCCCX2                                                                             XX
X                                                                                                            X2                CCCX2                                                                              XX
X                                                                                                             X2      E2      CCX2                                                                                XX
X                                                                                                              X2X2X2X2X2X2X2X2X2                                                                                 XX
X                                                                                                                                                                                                                 XX
X                                                                                                                                                                                                                 XX
X                                                                                                                                                                                                                 XX
X                                                                                                                                                                                                                 XX
X                                                                                                                                                                                                                 XX
X                                                                                                                                                                                                                 XX
X                                                                                                                                                                                                                 XX
X                                                                                                                                                                                                                 XX
X                                                                                                                                                                                                                 XX
X                                                                                                                                                                                                                 XX
X                                                                                                                                                                                                                 XX
X                                                                                                                                                         W                                                       XX
X                   XXXBBXXXX                                                                                                                             XX                                                    X2XX
X             C     B       B                                                                                                                            XXXX                                                 X2X2XX
X             C     B       B                                                                                                                          XXXXXXXX                                             X2X2X2XX
X             C     B   L   B                    E2                          J                                                                       XXXXXXXXXXX              C    C   C   C              X2X2X2X2XX
X    XXXXXXXXXXXXXXXXXXXXXXXXXXXXXXXXXXXXXXXXXXXXXXXXXXXXXXXXXXXXXXXXXXXXXXXXXXXXXXXXXXXXXXXXXXX  V  XXXXXXXXXXXXXXXXXXXXXXXXXXXXXXXXXXXXXXXXXXXXXXXXXXXXXXXXXXXXXXXXXXXXXXXXXXXXXXXXXXXXXXXXXXXXXXXXXXXXXXXXXXXXXXX
X                                                                                                                                                                                                                 XX
X                                                                                                                                                                                                                 XX
X                                                                                                                                                                                                                 XX
X                                                                                                                                                                                                                 XX
X                                                                                                                                                                                                                 XX
X                                                                                                                                                                                                                 XX
X                                                                                                                                                                                                                 XX
X                                                                                        XXXXXXX      XXXXXX                                                                                                      XX
X                                                                                                                                                                                                                 XX
X                                                                                                                                                                                                                 XX
X                                                                                                                                                                                                                 XX
X                                                                                                                                                                                                                 XX
X                                                                                 XXXXXX                                                                                                                          XX
X                                                                                                                                                                                                                 XX
X                                                                                                                                                                                                                 XX
X                                 C                                                                                                                                                                               XX
X                                CCC                                XXXXXXXXXX                                                                                                                                    XX
X                               CCCCC                                                                        X2                                                                                                   XX
X                              CCCCCC                                                                      X2X2X2                                                                                                 XXXXXXXXXX 
X                             CCCCCCCC                                                                   X2X2X2XX2X2                                                                                                         
X                    XXXXXXXXXXXXXXXXXXXXX                                                             BBBBBBBBBBBBBBBB                                                                                             
X                                                 E1                                                 BBBBBBBBBBBBBBBBBBBB                                      E2                                                 D
XXXXXXXXXXXXXXXXXXXXXXXXXXXXXXXXXXXXXXXXXXXXXXXXXXXXXXXXXXXXXXXXXXXXXXXXXXXXXXXXXXXXXXXXXXXXXXXXXXXXXXXXXXXXXXXXXXXXXXXXXXXXXXXXXXXXXXXXXXXXXXXXXXXXXXXXXXXXXXXXXXXXXXXXXXXXXXXXXXXXXXXXXXXXXXXXXXXXXXXXXXXXXXXXXXXXXXXXXXXX
