





X                                                                                                                                                                                       
X                                                                                                                                                                                     
X                           XXXXXXXXXXXXXXXXXXXXXXXXXXXXXXXXXX V                                                                                                                 XX X X   
X                           X                                                             CC        E2        E2             L                                                              X2  
X                   XXXXXXXXX                                                          XXXXXXXXXXXXXXXXXXXXXXXXXX H    XXXXXXX                                  C             XX        X2X H                     X
X         XXXX    XXXXX     X                                                                                                                                                                                     X
X                                                                                                                                                E2                                                               X
X                    CC               X                                                        C                       X2                        XX                    XXX                                        X
X P                                             E1  L      K X                    XXXXXXX           X            XX                                            C E2                       X2      L               X
XXXXXXXXXXXXXXXXXXXXXXXXXXXXXXXXXXXXXXXXXXXXXXXXXXXXXXXXXXXXXXXXXXXXXXXXX                 XXXXXXXXXXX                         XXX                              X2X2                     X2      C                 X
X                                                                        X            CC XXXXX                     XX                                        X2X2X2X2        XX         X2                        X
X                                                                         X     CC CC   XXXXXX                          E2        XX                       X2X2X2X2X2X2                 X2                        X
X                                                                          XXXXXXXXXXXXXXXXXXXXXXXXXXXXXXXXXXXXXXXXXXXXXXXXXXXXXXXXXXXXXXXXXXXXXXXXXXXXXXXXXXXXXXXXXXXXXXXXXXXXXXXXXXXXXXXXXXXXXXXXXXXXXXXXXXXX   X
X                                                                                                                                                                                                                 X
X                                                                                                                                                                                                                 X
X                                                                                                                                                                                                                 X
X                                                                                      BBB                                                  BB                                                                    X
X                       XBBBCCCBBB                                                     BBB                                                  BB                    C C C C                                         X
X                       XBBBBBBBBB                                                     BBB                                                  BB               XXXXXXXXXXXXXXXXXX                                   X
X                       XXX      X  XX  X                                              BBB                                                  BB               XXXXXXXXXXXXXXXXXXXX                                 X
X                                        X                 L   L                       BBB                                                  BB                                   XX                               X
X                                         X                                            BBB                E1 E1 E1    E1       E1   E1      BB                                      XX                            X
X   XXXXXXXXXXXXXXXXXX              XXXXXXXXXXXXXXXXXXXXXXXXXXXXXXXXXXXXXXXXXXXXXXXXXXXXXXXXXXXXXXXXXXXXXXXXXXXXXXXXXXXXXXXXXXXXXXXXXXXXXXXXXXXXXXXXXXXXXXXXXXXXXXXXXXXXXXXXXXXXXXXXXXXXXXXXXXXXXXXXXXXXXXXXXXXXXXX
X                      XXXXXXXXXXXXX                                                                                                                                                                              X
X                                                                                                                                                                                                                 X
X                                                                                                                                                                                                                 X
X                                                                                                                                                                                                                 X
X                                                                                                                                                                                                                 X
X                                                                                                                                                                                                                 X
X                          XXXXXXXX V XXXXXXXXXX                                                                 E2  E2   E2                                                                                      X
X                         XX                   B                                                               XXXXBBBXXXXXX                                                                                      X
X                        XXX                   B                                                               BBBBBBBBBBBBX                                                                                      X
X                       XXXX                   B                                                              XXXXXBLBXXXXXX                                                                                      X
X                     XXXXXX                   B                                                            XXXXXXXXXXXXXXXXXXX                                                                                   X
X                    XXXXXXX                   B                     J                                                                                                                                            X
X                  XXXXXXXXX    E1  L          B                                                                                                                                                                  X
XXXXXXXXXXXXXXXXXXXXXXXXXXXXXXXXXXXXXXXXXXXXXXXXXXXXXXXXXXXXXXXXXXXXXXXXXXXXXXXXXXXXXXXXXXXXXXXXXXXXXXXXXX                      CCCCCXXXXXXXXXXXXXXXXXXXXXXXXXXXXXXXXXXXXXXXXXXXXXXXXXXXXXXXXXXXX                 X
X                                                                            B                             X2I                 CCCC X2                                                                            X
X                                                                            B                              X2                 CCCCX2                                                                             X
X                                                                            B                               X2                CCCX2                                                                              X
X                                                                            B                                X2      E2      CCX2                                                                                X
X                                                                            B                                 X2X2X2X2X2X2X2X2X2                                                                                 X
X                                                                            B                                                                                                                                    X
X                                                                            B                                                                                                                                    X
X                                                                            B                                                                             W                                                      X
X                                                                            B                                                                                                                                    X
X                   XXXBBXXXX                                                B                                                                             XX                                                    XX
X             C     B       B                                                B                                                                            XXXX                                                 X
X             C     B       B                                                B                                                                           XXXXXXXX                                             X
X             C     B   L   B                    E3        E3     E3         B                                                                          XXXXXXXXXXX              C    C   C   C              X
X    XXXXXXXXXXXXXXXXXXXXXXXXXXXXXXXXXXXXXXXXXXXXXXXXXXXXXXXXXXXXXXXXXXXXXXXXXXXXXXXXXXXXXXXXXXX  V  XXXXXXXXXXXXXXXXXXXXXXXXXXXXXXXXXXXXXXXXXXXXXXXXXXXXXXXXXXXXXXXXXXXXXXXXXXXXXXXXXXXXXXXXXXXXXXXXXXXXXXXXXXXXXX
X                                                                                                                                                                                                                 X
X                                                                                                                                                                                                                 X
X                                                                                                                                                                                                                 X
X                                                                                        XXXXXXX      XXXXXX                                                                                                      X
X                                                                                                                                                                                                                 X
X                                                                                 XXXXXX                                                                                                                          X
X                                 C                                                                                                                                                                               X
X                                CCC                                XXXXXXXXXX                                                                                                                                    X
X                               CCCCC                                                                        X2                                                                                                   X
X                              CCCCCC                                                                      X2X2X2                                                                                                 X
X                             CCCCCCCC                        V                                           X2X2X2XX2X2                                                                                              D          
X         J          XXXXXXXXXXXXXXXXXXXXX                                        F                     BBBBBBBBBBBBBBBB                                                                                             
X                                                 E1                                                 BBBBBBBBBBBBBBBBBBBB          E3             E3        E3       E2             E3     E3               K                
XXXXXXXXXXXXXXXXXXXXXXXXXXXXXXXXXXXXXXXXXXXXXXXXXXXXXXXXXXXXXXXXXXXXXXXXXXXXXXXXXXXXXXXXXXXXXXXXXXXXXXXXXXXXXXXXXXXXXXXXXXXXXXXXXXXXXXXXXXXXXXXXXXXXXXXXXXXXXXXXXXXXXXXXXXXXXXXXXXXXXXXXXXXXXXXXXXXXXXXXXXXXXXXXXXXX
