








X                                       C                                                                                                                                                
X                                       C                                                                                                                                               
X                           XXXXXXXXX  CCCC                                                                                                                                                     
X                          X         X CCCC                                                                                                                                                 
X                         X           XCCCC                                                                                                                                                                       XX
X              XXXXXXXXXXX             XXXXXXX                                                                                                                                                                    XX
X P            X         X                   X  E1  L                                                                                                                                             BXXBBXXX        XX
XXXXXXXXXXXXXXXXXXXXXXXXXXXXXXXXXXXXXXXXXXXXXXXXXXXXXXXXXXXXXXXXXXXXXXXXXXXX                                                                 C    C                                               BB     BB       XX
X                                                                          X                                                                 C    C        X2X2                                   BB  L  BB       XX
X       C                                                                  X         E2                                     W                C    C        X2X2                      E2           BB     BB       XX
X       C                                                                  XXXXXXXXXXXXXXXXXXXXXXXXXXXXX        XXXXXXXXXXXXXXXXXXXXXXXXXXXXXXXXXXXXXXXXXXXXXXXXXXXXXXXXXXXXXXXXXXXXXXXXXXXXXXXXXXXXXXXXXXXXXXX   XX
X       C                                                                                               X2                                                                                                        XX    
X                                                                                                         X2                                                                                                      XX                                                                                                    
X                                                                                                           X2                                                    S                                               XX       
X       X2                                                                                                    X2                                                                                                  XX 
X       X2X2                                                                                                    X2                                               X2X2                                             XX       
X       X2X2X2                                                                                                    X2                                            X2  X2                                            XX    
X       X2X2X2X2                     XXXXXXXXX                                                                      BB                                         X2    X2                                           XX     
X       X2X2X2X2X2                  XXXXXXXXXXX                                                                       BB                                      X2      X2                                          XX
X       X2X2X2X2X2X2              XX          XX                                 E2                                    BB               E3                   X2        X2                                         XX
X    XXXXXXXXXXXXXXXXXXXXXXXXXXXXXXX          XXXXXXXXXXXXXXXXXXXXXXXXXXXXXXXXXXXXXXXXXXXXXXXXXXXXXXXXXXXXXXXXXXXXXXXXXXXXXXXXXXXXXXXXXXXXXXXXXXXXXXXXXXXXXXXXXXXXXXXXXXXXXXXXXXXXXXXXXXXXXXXXXXXXXXXXXXXXXXXXXXXXXX
X                                                                                                                                                                                                                 XX
X                                                                                                                                                                                                                 XX      
X                                                                                                                                                                                                                 XX
X                                                                                                                                                                                                                 XX
X                                                                                                                                                                                                                 XX
X                                    X2  V  X2X2X2X2X2X2X2X2BBBBBBBBBBBBBBX2X2                                                                                                                                    XX
X                                  X2                     X2          X2      X2                                                                                                                                  XX
X                                X2                       X2         X2         X2                                                                                                                                XX
X                              X2                         X2        X2            X2                                                                                                                              XX
X                            X2                           X2  K   X2                X2                                                                                                                            XX
X                          X2                             X2X2X2X2                    X2                                                                                                                          XX
X                        X2                                                             X2   C                                                                                                                    XX
X                      X2                                                                 X2                                                                                                                      XX
X                    X2                                                                     X2 C                                                                                                                  XX
X                  X2                                                                         X2                                  C    C    C                                                                     XX
X                X2                                                                             BB C                              C    C    C                     XXX                                             XX
X              X2                                                                                 BB                              C    C    C                    XXXX                                             XX
X            X2                                                                                     BB                            C    C    C                   XXXXX                E1                           XX
XXXXXXXXXXXXXXXXXXXXXXXXXXXXXXXXXXXXXXXXXXXXXXXXXXXXXXXXXXXXXXXXXXXXXXXXXXXXXXXXXXXXXXXXXXXXXXXXXXXXXXXXXXXXXXXXXXXXXXXXXXXXXXXXXXXXXXXXXXXXXXXXXXXXXXXXXXXXXXXXXXXXXXXXXXXXXXXXXXXXXXXXXXXXXX
X                                                                                                                                                                                             X                   XX
X                                                                                                                                                                                              X                  XX
X                                                                                                                                                                                               X                 XX
X                                                                                                                                                                                                X                XX
X                                                                                                                                                                                                 X               XX
X                                                                                                                                                                                                  X              XX  
X                                                                                                                                                                                                                 XX
X                                                                                                                                                                                                                 XX
X                                                                                                                                                                                                                 XX
X                                                                                                                                                                                                                 XX
X                                                                                                                                                                                                    XXXXXXXXXX   XX
X                                                                                                                                                                                                   X             XX
X                                                                                                                                                                                                  X              XX
X                                                                                                                                                                                                 X               XX
X                                                                                                                                                                                                X                XX
X                                                                                                                                                                                               X                 XX
X                                                                W                                                                                                                             X                  XX
X                                                            X2X2X2X2X2                                                                                                                       X                   XX
X                                                            X2X2X2X2X2X2                                                                                                                    X                    XX
X                                                            X2X2X2X2X2X2X2                                                                                                                 X                     XX
X                                                            X2X2X2X2X2X2X2X2                                       CCC                                                                    X                      XX
X                                                            X2X2X2X2X2X2X2X2X2                                     CCC                                                                    X                      XX
X                                                            X2X2X2  L X2X2X2X2X2      X2X2X2                       CCC                                                                    X                      XX
X                                                            X2X2X2    BBBBBBBBBBBB                                                                                                        X                      XX
X                                                            X2X2X2X2BBBBBBBBBBBBBBBB                                V                                                                     X                      XX
X                                        E3                  X2X2X2X2BBBBBBBBBBBBBBBBBB                                                                                                    X                      XX
X              XXXXXXXXXXXXXXXXXXXXXXXXXXXXXXXXXXXXXXXXXXXXXXXXXXXXXXXXXXXXXXXXXXXXXXXXXXXXXXXXXXXXXXXXXXXXXXXXXXXXXXXXXXXXXXXXXXXXXXXXXXXXXXXXXXXXXXXXXXXXXXXXXXXXXXXXXXXXXXXXXXXXXXXXXXXXX                      XX
X              X                                                                                                                                                                                                  XX
X              X                                                                                                                                                                                                  XX
X              X                                                                                                                                                                                                  XX
X              X                                                                                                                                                                                                  XX
X              X                                                                                                                                                                                                  XX
X              X                                                                                                                                                                                                  XX
X              X                                                                                                                                                                                                  XX
X              X                                                                                                                                                                                                  XX
X              X                                                                                                                                                                                                  XX
X              X                         X  H      H  X                                                                                                                                                           XX
X              X                        X              X                                                                                                                                                          XX
X              X                       X                X                                                                                                                                                         XX
X              X                      X                  X                                  C     C                                                                          C                                    XX
X                                    X                    X                                                                                                                                                       XXXXXXX
X                                   X                      B                                C     C                                                      XXXXXXXXXX          C                                     D 
X                                  X                        B                                                                                            XXXXXXXXXX                                                 
X                                 X         E3       E3      B                      C   C   C     C    C   C              E2                             XXXXXXXXXX          C               K                      
XXXXXXXXXXXXXXXXXXXXXXXXXXXXXXXXXXXXXXXXXXXXXXXXXXXXXXXXXXXXXXXXXXXXXXXXXXXXXXXXXXXXXXXXXXXXXXXXXXXXXXXXXXXXXXXXXXXXXXXXXXXXXXXXXXXXXXXXXXXXXXXXXXXXXXXXXXXXXXXXXXXXXXXXXXXXXXXXXXXXXXXXXXXXXXXXXXXXXXXXXXXXXXXXXXXXXXXXX 
