XXXXXXXXXXXXXXXXXXXXXXXXXXXXXXXXXXXXXXXXXXXXXXXXXXXXXXXXXXXXXXXXXXXXXXXXXXXXXXXXXXXXXXXXXXXXXXXXXXXXXXXXXXXXXXXXXXXXXXXXXXXXXXXXXXXXXXXXXXXXXXXXXXXXXXXXXXXXXXXXXXXXXXXXXXXXXXXXXXXXXXXXXXXXXXXXXXXXXXXXXXXXXXXXXXXXXXXXXXXXXXXX                                                                                                              X                                                                                                                                                                                                                              X
X                                                                                                                                                                                   X3                                         X
X                                                                                                                                                                                                                              X
X                                                                                                                                                                                                                              X
X                                                                                                                                                                                X                                             X
X                                              X2                 X2                 XX                                                                                                                                        X
X                                  X                                            X                                                                                                                                              X
X                                  XX                                          XX         XXXX                                                               XX                                            XXX                 X
X               XXX      XX        XX                   E1                     XX                           X           E2                 E2            X                 X                        E1    X                    X
X             XXXXX      XX        XXXXXXXXXXXXXXXXXXXXXXXXXXXXXXXXXXXXXXXXXXXXXX                    XXX    XXXXXXXXXXXXXXXXXXXXXXXXXXXXXXXXXXXXXXXXXXXXXX       X   XX    XXXXXXXXXXXXXXXXXXXXXXXXXXXXXXXX       XXX          X
X P          XXXXXX      XX                                                                                                                                                                                       XXXXXXX      X
XXXXXXXXXXXXXXXXXXXXXXXXXXXXXXXXXXXXXXXXXXXXXXXXXXXXXXXXXXXXXXXXXXXXXXXXXXXXXXXXXXXXXXXXXXXXXXXXXXXXXXXXXXXXXXXXXXXXXXXXXXXXXXXXXXXXXXXXXXXXXXXXXXXXXXXXXXXXXXXXXXXXXXXXXXXXXXXXXXXXXXXXXXXXXXXXXXXXXXXXXXXXXXXXXXXXXXXXX      X
X                                                                                                                                                                                                                              X
X                                                                                                                                                                                                                              X
X                                                                                                                                                                                                                              X
X                                 X                        X                                             XX                       XX                                                                                           X
X                                 XXXXXXXXXXXXXXXXXXXXXXXXXX                                              XXXXXXXXXXXXXXXXXXXXXXXXXX                                     X    X                                                X
X                                                                 X                              X                                        X                              X                                          XXX        X
X                                                                 XXXXXXXXXXXXXXXXXXXXXXXXXXXXXXXX                                        XXXXXXXXXXXXXXXXXXXXXXXXXXXXXXXX                                                     X
X                                                                                                                                                                                XXXXXXXXX      XXXX        XXX                X
X                   XXXXXBBB      XXXXXXXXXXXXXXXXXXXXXXXXXXX                                             XXXXXXXXXXXXXXXXXXXXXXXXXX                                                                                       XXXXX
X                 XXXXXX                                                                                                                                                                                                       X
X      XX       XXXXXXXX                                          XXXXXXXXXXXXXXXXXXXXXXXXXXXXXXXX    X                                   XXXXXXXXXXXXXXXXXXXXXXXXXXXXXXXX   X                                                 X
X      XXX    XXXXXXXXXX                                                                                                                                                                                                       X
X      XXXXXXXXXXXXXXXXXXXXXXXXXXXXXXXXXXXXXXXXXXXXXXXXXXXXXXXXXXXXXXXXXXXXXXXXXXXXXXXXXXXXXXXXXXXXXXXXXXXXXXXXXXXXXXXXXXXXXXXXXXXXXXXXXXXXXXXXXXXXXXXXXXXXXXXXXXXXXXXXXXXXXXXXXXXXXXXXXXXXXXXXXXXXXXXXXXXXXXXXXXXXXXXXXXXXXXXXX
X                                                                                                                                                                                                                              X
X                                                                                                                                                                                                                              X
X                                                                                                                              I                                                                                               X
X                                                                                                                                                                                                                              X
X                                                                                        X                                                X                                                                                    X
X                                                                                        X                                                X                                                                                    X
X                                                                                        X                        E2                      X                                        E2                                          X
X                                                                                        XXXXXXXXXXXXXXXXXXXXXXXXXXXXXXXXXXXXXXXXXXXXXXXXXX                                       XXXX                                         X
X                 XXXX       X                                              X                                                                                                                                   X              X
X               XXXXXX       X                        E3                  XXX        XX                                                        XXXX          X        E3                                        X              X
X             XXXXXXXX       XXXXXXXXXXXXXXXXXXXXXXXXXXXXXXXXXXXXXXXXXXXXXXXX        XX                                                        XXXXXX        XXXXXXXXXXXXXXXXXXXXXXXXXXXXXXXXXXXXXXXXXXXXXXXXXXXX    XXX       X 
X           XXXXXXXXXX                                                    XX         XX                                                        XXXXXXXX                                                              XXXX      X
XXXXXXXXXXXXXXXXXXXXXXXXXXXXXXXXXXXXXXXXXXXXXXXXXXXXXXXXXXXXXXXXXXXXXXXXXXXXXXXXXXXXXXXXXXXXXXXXXXXXXXXXXXXXXXXXXXXXXXXXXXXXXXXXXXXXXXXXXXXXXXXXXXXXXXXXXXXXXXXXXXXXXXXXXXXXXXXXXXXXXXXXXXXXXXXXXXXXXXXXXXXXXXXXXXXXXXXXX      X                                                                                                                                                                                                                            X                                                                                                                                                                                                                              X
X                                                                                                                                                                                                                              X
X                                                                                                                                                                                                                              X
X                                                                                                                                                                                                                              X
X                         X                                           X             X                                   X                                                                                                      X
X                         XXXXXXXXXXXXXXXXXXXXXXXXXXXXXXXXXXXXXXXXXXXXX      XX     XXXXXXXXXXXXXXXXXXXXXXXXXXXXXXXXXXXXX               XXXXXXXXXXXXXXXXXXXXXXXXXXXXXXXXXXXXXXXXXXXXXXXXXXX                             V      X
X                                                                                                                                                                                                                              X
X                                                                                                                                                                                                                              X
X                 XXXX                                                                                                  X                                                                                                      X
X               XXXXXX                                                    XX     XXXXXXXXXXXXXXXXXXXXXXXXXXXXXXXXXXXXXXXX      XX       XXXXXXXXXXXXXXXXXXXXXXXXXXXXXXXXXXXXXXXXXXXXXXXXXXXXX     XXXXXX      XXXXX            X
X             XXXXXXXX    XXXXXXXXXXXXXXXXXXXXXXXXXXXXXXXXXXXXXXXXXX      XX                                                   XX                                                                                              X
X           XXXXXXXXXX                                                    XX                                                   XX                                                                                              X
X      XXXXXXXXXXXXXXXXXXXXXXXXXXXXXXXXXXXXXXXXXXXXXXXXXXXXXXXXXXXXXXXXXXXXXXXXXXXXXXXXXXXXXXXXXXXXXXXXXXXXXXXXXXXXXXXXXXXXXXXXXXXXXXXXXXXXXXXXXXXXXXXXXXXXXXXXXXXXXXXXXXXXXXXXXXXXXXXXXXXXXXXXXXXXXXXXXXXXXXXXXXXXXXXXXXXXXXXXX                                                                                                                                                                                                                                   X                                                                                                                                                                                                                              X
X                                                                                                                                                                                                                              X
X                                                                                                                                                                                                                              X
X                                                                                                                                                                                            XX                                X
X                                                                                                                                                                                            XX                                D
X                                                                                                                                                                                            XX       XX                       D
X                                                                                                    X                                                                                                XX                       D
XXXX                        X                                      XX                        V       X                                                                                                XX                       D
X                 XXXX      X                                      XX                                X                                                                      B1                        XX                       D
X               XXXXXX      X             E2               E3      XX     XXX       XXX              XXXXXXXXXXXXXXXXXXXXXXXXXXXXXXXXXXXXXXXXXXXXXXXXXXXXXXXXXXXXXXXXXXXXXXXXXXXXXXXXXXXXXXXXXXXXXXXXXXX                       D
X             XXXXXXXX      XXXXXXXXXXXXXXXXXXXXXXXXXXXXXXXXXXXXXXXXX     XXX       XXX                                                                                                                                        D
X           XXXXXXXXXX                                                    XXX       XXX                                                                                                                                        D
XXXXXXXXXXXXXXXXXXXXXXXXXXXXXXXXXXXXXXXXXXXXXXXXXXXXXXXXXXXXXXXXXXXXXXXXXXXXXXXXXXXXXXXXXXXXXXXXXXXXXXXXXXXXXXXXXXXXXXXXXXXXXXXXXXXXXXXXXXXXXXXXXXXXXXXXXXXXXXXXXXXXXXXXXXXXXXXXXXXXXXXXXXXXXXXXXXXXXXXXXXXXXXXXXXXXXXXXXXXXXXXXXXXX

